TTT	F	Phe	Phenylalanine
TTC	F	Phe	Phenylalanine
TTA	L	Leu	Leucine
TTG	L	Leu	Leucine
CTT	L	Leu	Leucine
CTC	L	Leu	Leucine
CTA	L	Leu	Leucine
CTG	L	Leu	Leucine
ATT	I	Ile	Isoleucine
ATC	I	Ile	Isoleucine
ATA	I	Ile	Isoleucine
ATG	M	Met	Methionine
GTT	V	Val	Valine
GTC	V	Val	Valine
GTA	V	Val	Valine
GTG	V	Val	Valine
TCT	S	Ser	Serine
TCC	S	Ser	Serine
TCA	S	Ser	Serine
TCG	S	Ser	Serine
CCT	P	Pro	Proline
CCC	P	Pro	Proline
CCA	P	Pro	Proline
CCG	P	Pro	Proline
ACT	T	Thr	Threonine
ACC	T	Thr	Threonine
ACA	T	Thr	Threonine
ACG	T	Thr	Threonine
GCT	A	Ala	Alanine
GCC	A	Ala	Alanine
GCA	A	Ala	Alanine
GCG	A	Ala	Alanine
TAT	Y	Tyr	Tyrosine
TAC	Y	Tyr	Tyrosine
TAA	*	***	Stop (Ochre)
TAG	*	***	Stop (Amber)
CAT	H	His	Histidine
CAC	H	His	Histidine
CAA	Q	Gln	Glutamine
CAG	Q	Gln	Glutamine
AAT	N	Asn	Asparagine
AAC	N	Asn	Asparagine
AAA	K	Lys	Lysine
AAG	K	Lys	Lysine
GAT	D	Asp	Aspartic acid
GAC	D	Asp	Aspartic acid
GAA	E	Glu	Glutamic acid
GAG	E	Glu	Glutamic acid
TGT	C	Cys	Cysteine
TGC	C	Cys	Cysteine
TGA	*	***	Stop (Opal)
TGG	W	Trp	Tryptophan
CGT	R	Arg	Arginine
CGC	R	Arg	Arginine
CGA	R	Arg	Arginine
CGG	R	Arg	Arginine
AGT	S	Ser	Serine
AGC	S	Ser	Serine
AGA	R	Arg	Arginine
AGG	R	Arg	Arginine
GGT	G	Gly	Glycine
GGC	G	Gly	Glycine
GGA	G	Gly	Glycine
GGG	G	Gly	Glycine
